M_ARIF	MACIVI
M_M_ASHHAR MMACIVI
S_A_ANSARI	SAACIVI
M_MUZZAMMIL	MMCIVI
A_BAQI	ABCIVI
I_H_FAROOQI	IHFCIVI
S_AHMAD	SACIVI
A_MASOOD	AMCIVI
M_ATHAR	MA2CIVI
T_NAQVI	TNCIVI
S_AKHTAR	SACIVI
T_MANSOOR	TMCIVI
A_UMAR	AUCIVI
R_A_KHAN	RAKCIVI
A_KHURSHEED	AKCIVI
K_ALI	KACIVI
T_AHMAD	TACIVI
A_A_SIDDIQUI	AASCIVI
S_A_ALI	SAACIVI
M_BEG	MBCIVI
M_S_JAFRI	MSJCIVI
H_IRTAZA	HICIVI
F_MAHDI	FMCIVI
J_ALAM	JACIVI
M_M_ALAM	MMACIVI
S_AYUB	SACIVI
M_A_KHAN	MAKCIVI
M_A_ANSARI	MAACIVI
I_K_KHAN	IKKCIVI
M_S_AHMAD	MSACIVI
N_KHALIL	NKCIVI
S_D_HASAN	SDHCIVI
M_A_FAROOQI	MAFCIVI
M_SHARIQ	MSCIVI
F_BASHEER	FBCIVI
A_HUSSAIN	AHCIVI
M_ARSALAN	MACIVI
M_R_SADIQUE	MRSCIVI
M_S_UMAR	SUCOMP
N_AHMAD	NACOMP
A_M_ABBAS	AMACOMP
M_R_WARSI	MRWCOMP
IZHARUDDIN	ICOMP
M_A_ALI	MAACOMP
R_ALI	RACOMP
S_ISLAM	SICOMP
M_A_QADEER	MAQCOMP
N_AKHTAR	NA2COMP
M_INAMULLAH	MICOMP
T_A_CS	TACOMP
A_M_KHAN	AMCOMP
M_H_KHAN	MHKCOMP
A_ASLAM	AACOMP
M_IMRAN	MI2COMP
G_SIDDIQUI	GSCOMP
ACRKOR